11111111111000
13022222001000
10121212101000
12222222221000
12121212121000
12222222221000
12121212121000
12222222221000
10121212101000
16022222051000
11111111111000
00000000000000
00000000000000
00000000000000