11111111111
13022222001
10121212101
12222222221
12121212121
12222222221
12121212121
12222222221
10121212101
10022222051
11111111111