11111111111
13022222001
11012121211
12222222221
11212121211
12222222221
11212121211
12222222221
11012121011
16078922051
11111111111