11111111111
13122222101
10021112001
12122222121
12221212221
11111211111
12221212221
12122222121
10021112001
16178922151
11111111111