11111111111
13022222001
10222222201
12222222221
12222222221
12222222221
12222222221
12222222221
10222222201
16022222051
11111111111